#  ### ############ #
## ###          ### #
#  ### ############ #
## # #    ######### #
##   #### ######### #
#### ####        ## #
#  #   ## ##### ### #
#  ### ## ##### ### #
          #####     #
#####################