########   ##   ##########################
##########   ##   ####      ########   ###
#####   #####   ########   #####  ########
###   #####   ####   ############ ########
########   #######   ######        #######
#   ##   #######   ################  #####
########   ##      ##############  #######
####   ######   ###############  #########
#######   ######   #####   ##### #########
##   ######   #####    #######   #########
   #####   #   ####   #####        # #####
#####   ####   #####   #############  ####
###   #   #####   ####   #####   ####   ##
########   #######   ####               ##
##    ################   #################