#  # # ############ #
## ##           ### #
#  ### ############ #
## # #    ######### #
##   #### ######### #
#### ####        ## #
#  #   ## ##### ### #
#  ### ## ##### ### #
          #####     #
#####################